R 1366 768
NO ./textures/texture.xpm
SO ./textures/texture2.xpm
EA ./textures/texture3.xpm
WE ./textures/texture4.xpm
S ./textures/sprite1.xpm
C 0,20,122
F 122,122,0


11111111111111111111111111
10000000000000000000000001
10000000000000000000000001
10000000000200000000000001
10000000000N00000000000001
10000000000000000000000001
10000000000000000000000001
10000000022222000000000001
11111111111111111111111111